* ก -> ח 
* ข -> υ
* ค-> ค
* ง -> ᴊ
* จ -> จ
* ช -> ช
* ญ = ญ
* ฒ -> ฒ
* ณ -> ณ
* ด -> ด
* ต -> ต
* ท -> n
* ธ -> ธ
* น -> u
* บ -> ᴜ
* ป -> ป
* ผ -> ผ
* ฝ -> ฝ
* พ -> ω
* ฟ -> ฟ
* ภ -> ภ
* ม -> ม
* ย -> ε
* ร -> ѕ
* ล -> 𝚊
* ว -> ว
* ษ = ษ
* ส -> ส
* ห -> ห
* ฬ -> ฬ
* อ -> o
* ฮ -> ฮ
* สระ โอ -> โ
* สระ ไอ -> ไ
* สระ เอ -> ℓ 
* สระ แอ -> ιι
* สระ อิ -> ิ
* สระ อะ -> ะ
* สระ อา -> อๅ